111111111111111111111
10C10000000C000000001
100001111111111110001
1P0011E0000C000000001
111111111111111111111
