11111111111111111111111111111
1E0000000000000000000000000C1
10111111011111111111011111101
100000C100000000000001C000001
10111101011111011111010111101
10000101000000000000010100001
10110101011111011111010101101
10000100000000000000000100001
10110101010111110101010101101
100000010101C000C101010101101
101101010101C000C101010000001
10110101010111111101010101101
10000100000000000000000100001
10110101011111011111010101101
10000101000000000000010100001
10111101011111011111010111101
100000C100000000000001C000001
10111111011111111111011111101
1C000000000000P000000000000C1
11111111111111111111111111111
