11111111111111111111111111111111111111111
1E0RRR00000CC0000000000000RRR000000000001
10000000CCC000000000R000R000100000000CCC1
1000R000CCC000R0000CCCCCC010000000000CRC1
1000000R0000R0C000000R0000R1R00000000CCC1
1000R000000000C00R00000000R1R000000000001
1P000000R00000C000RRR00CCCR1R000000000001
11111111111111111111111111111111111111111
