11111111111111111111111111111
1E00CCCCCCCCCC0000R00000000C1
10111111011111111111011111101
1000CCC1C0000000000001C000001
10111101C11111011111010111101
10000101CR0000000000010100001
10110101C11111011111010101101
10000100C0000000R000000100001
10110101C10111110101010101101
1000R001C101C000C101010101101
10110101C101C000C10101000R001
10110101C10111111101010101101
10000100C0000R000000000100001
10110101C11111011111010101101
10000101C00000000000010100001
10111101011111011111010111101
1000R0C10000000CC0C001C000001
10111111011111111111011111101
1C000000000000P0000CCCCCCCCC1
11111111111111111111111111111
